1	                     number 
10	                     number
100	                     number 
13.00	                 time 
14.00	                 time 
15	                     number 
17	                     number 
2	                     number 
20	                     number 
200	                     number 
250	                     number 
270	                     number 
3	                     number 
30-40	                 number  
300	                     number 
40	                     number  
5	                     number 
70-річні	             adj:p:v_naz 
Ємність	                 noun:f:v_naz 
І	                     conj:coord
Їли	                     verb:past:p:imperf 
Їх	                     pron:pers:p:3:v_rod:anim
А	                     conj:coord
А	                     part 
Але	                     conj:coord
Асортимент	             noun:m:v_naz 
БІЛЬШЕ	                 adv:compr 
БУДЕ	                 verb:futr:s:3:imperf
Була	                 adjp:actv:past:f:v_naz 
Були	                 verb:past:p:imperf 
Біля	                 adv 
Вибір	                 noun:m:v_naz 
Висновок	             noun:m:v_naz 
Виявляється	             verb:rev:pres:s:3:imperf 
Вона	                 pron:pers:f:3:v_naz:anim
Всяке	                 adj:n:v_naz:&pron:gen:v-u 
Всі	                     adj:p:v_naz:&pron:dem
Вчора	                 adv:v-u  
Від	                     prep:rv_rod 
До	                     prep:rv_rod 
Довго	                 adv:compb 
Довелось	             verb:rev:past:n:perf 
Досить	                 adv 
Дякую	                 verb:pres:s:1:imperf 
Дівчина	                 noun:f:v_naz:anim 
З	                     prep:rv_rod:rv_zna:rv_oru 
Зверніть	             verb:impr:p:2:perf
Звісно	                 adv 
Києві	                 noun:m:v_mis 
Коли	                 adv:&pron:int:rel
Куряча	                 adj:f:v_naz 
Львова	                 noun:m:v_rod   
Львові	                 noun:m:v_mis 
Львів	                 noun:m:v_naz 
Львів	                 noun:m:v_zna 
МОЄЇ	                 adj:f:v_rod:&pron:pos 
Менеджер	             noun:m:v_naz:anim 
Менеджери	             noun:p:v_naz:anim 
Мені	                 noun:m:v_mis
Ми	                     pron:pers:p:1:v_naz:anim
Моє	                     adj:n:v_naz:&pron:pos 
Між	                     prep:rv_rod:rv_zna:rv_oru 
Мінуси	                 noun:p:v_zna  
НЕ	                     part 
НОГИ	                 noun:f:v_rod 
На	                     prep:rv_zna:rv_mis 
Навчіть	                 verb:impr:p:2:perf 
Нагорі	                 adv 
Наприкінці	             adv 
Наскільки	             adv 
Натомість	             adv 
Не	                     part 
Обов'язково	             adv 
Охоронець	             noun:m:v_naz:anim 
ПОМІЩАЄТЬСЯ	             verb:rev:pres:s:3:imperf 
Персоналу	             noun:m:v_rod 
Плюси	                 noun:p:v_zna 
Подбати	                 verb:inf:perf 
Пожерли	                 verb:past:p:perf 
Працівниця	             noun:f:v_naz:anim
Прийшли	                 verb:past:p:perf 
Прохання	             noun:n:v_naz
Пузатої	                 adj:f:v_rod 
Пузатій                  adj:f:v_mis 
Пізніше	                 adj:n:v_zna:compr  
Річ	                     noun:f:v_naz 
Сита	                 adj:f:v_naz
Смачна	                 adj:f:v_naz:compb 
Смачно	                 adv:compb 
Смішно	                 adv 
Спочатку	             adv 
Стрільців	             noun:p:v_rod:anim 
Сьогодні	             adv 
Січ	                     noun:f:v_zna
Січових	                 adj:p:v_mis 
Січових	                 adj:p:v_zna 
ТАМ	                     adv:&pron:dem 
Та	                     conj:coord
Таке	                 adj:n:v_zna:&pron:def
Тепер	                 adv:&pron:dem 
То	                     conj:subord 
Тобто	                 conj:subord
Треба	                 predic 
Тільки	                 adv
Тільки	                 part 
У	                     prep:rv_zna:rv_mis:rv_rod:v-u 
Фаст-фуд	             noun:m:v_naz 
Ходимо	                 verb:pres:p:1:imperf 
Хоча	                 conj:subord
Це	                     adj:n:v_naz:&pron:dem 
Ціни	                 verb:impr:s:2:imperf
Часто	                 adv:compb 
Шевченка	             noun:m:v_rod:anim:lname 
Щодо	                 prep:rv_rod 
Я	                     pron:pers:s:1:v_naz:anim
Який	                 adj:m:v_naz:&pron:int:rel:def
Якось	                 adv:&pron:ind 
а	                     conj:coord
або	                     conj:coord 
абсолютно                adv 
аж	                     part
акуратні	             adj:p:v_naz:compb 
але	                     conj:coord 
аналогічному	         adj:n:v_mis 
апогею	                 noun:m:v_rod 
аргументувати            verb:inf:imperf
б	                     part 
бажання	                 noun:n:v_naz 
бажаю	                 verb:pres:s:1:imperf 
банком	                 noun:m:v_oru 
банку	                 noun:m:v_dav 
барною	                 adj:f:v_oru 
барі	                 noun:m:v_mis 
батьках	                 noun:p:v_mis:anim 
батьки	                 noun:p:v_naz:anim 
бачили	                 verb:past:p:imperf 
без	                     prep:rv_rod 
беріть	                 verb:impr:p:2:imperf 
близько                  adv:compb 
бо	                     conj:subord  
брати	                 verb:inf:imperf
був	                     verb:past:m:imperf 
буваю	                 verb:pres:s:1:imperf 
буває	                 verb:pres:s:3:imperf  
буду	                 noun:f:v_zna 
була	                 adjp:actv:past:f:v_naz                                            
були	                 verb:past:p:imperf 
було	                 verb:past:n:imperf 
бути	                 verb:inf:imperf
більше	                 adv:compr 
бісить	                 verb:pres:s:3:imperf 
в	                     prep:rv_zna:rv_mis:rv_rod:v-u
важко	                 adv:compb 
вареники	             noun:p:v_zna 
вас	                     pron:pers:p:2:v_mis:anim
ваших	                 adj:p:v_rod:&pron:pos 
вдалося	                 verb:rev:past:n:perf:v-u 
вдвічі	                 adv 
великий	                 adj:m:v_naz:compb 
великою	                 adj:f:v_oru:compb 
велику	                 adj:f:v_zna:compb
великі	                 adj:p:v_naz:compb 
вечора	                 noun:m:v_rod 
вже	                     adv:v-u 
взагалі                  adv:v-u 
взамін	                 adv:bad 
взаєморозуміння	         noun:n:v_zna 
взяли	                 verb:past:p:perf 
взяти	                 verb:inf:perf 
ви	                     pron:pers:p:2:v_naz:anim
вибачилась	             verb:rev:past:f:perf 
вибір	                 noun:m:v_naz 
вигляд	                 noun:m:v_zna 
видають	                 verb:pres:p:3:imperf 
вийти	                 verb:inf:perf:perf 
виливається	             verb:rev:pres:s:3:imperf
вирішив 	             verb:past:m:perf 
вирішила	             verb:past:f:perf  
вирішили	             verb:past:p:perf 
вистачає	             verb:pres:s:3:imperf
витрачаємо               verb:pres:p:1:imperf
виявився	             verb:rev:past:m:perf 
виявилося	             verb:rev:past:n:perf 
власників	             noun:p:v_rod:anim
влаштовує	             verb:pres:s:3:imperf:v-u 
внизу	                 adv:v-u 
води	                 verb:impr:s:2:imperf
вона	                 pron:pers:f:3:v_naz:anim
вороття	                 noun:n:v_naz
вражені	                 adjp:pasv:past:p:v_zna 
все	                     adv:v-u
всього	                 adj:m:v_rod:&pron:dem 
всі	                     adj:p:v_naz:&pron:dem 
відвідування             noun:n:v_zna 
відвідувачів             noun:p:v_rod:anim 
відкрилась	             verb:rev:past:f:perf 
відношенні	             noun:n:v_mis 
відповіла	             verb:past:f:perf 
відповіли	             verb:past:p:perf
відразу	                 adv 
відсутня	             adj:f:v_naz 
відчутно	             adv:compb 
візьмете	             verb:futr:p:2:perf  
вільною	                 adj:f:v_oru:compb  
гаманець	             noun:m:v_zna 
гамбургери               noun:p:v_zna 
гарнір	                 noun:m:v_zna 
гарячі	                 adj:p:v_zna:compb 
глечиках	             noun:p:v_mis 
глінтвейну	             noun:m:v_dav
говорити	             verb:inf:imperf
години	                 noun:p:v_zna 
годині	                 noun:f:v_dav 
голодні	                 adj:p:v_zna:compb
горілки	                 noun:f:v_rod
готують	                 verb:pres:p:3:imperf 
грамах	                 noun:p:v_mis 
грамів	                 noun:p:v_rod 
гривень	                 noun:p:v_rod 
гроші	                 noun:p:v_zna 
гуляла	                 verb:past:f:imperf 
гірше	                 adj:n:v_naz:compr
дати	                 verb:inf:perf
день	                 noun:m:v_zna 
десь	                 adv:&pron:ind
дешевше	                 adj:n:v_naz:compr 
дещо	                 adv  
для	                     prep:rv_rod  
дня	                     noun:m:v_rod 
днях	                 noun:p:v_mis 
до	                     prep:rv_rod 
довгих	                 adj:p:v_rod:compb 
додому	                 adv 
дожовували	             verb:past:p:imperf 
дозволити	             verb:inf:perf 
докладають	             verb:pres:p:3:imperf
доливають	             verb:pres:p:3:imperf 
долити	                 verb:inf:perf  
домашня	                 adj:f:v_naz 
дорогі	                 adj:p:v_zna:compb 
досить	                 adv 
достатньо	             adv 
дочекатись	             verb:rev:inf:perf 
доїдять	                 verb:futr:p:3:perf 
друзі	                 noun:p:v_naz:anim 
дуже	                 adv 
думали	                 verb:past:p:imperf 
дівчат	                 noun:p:v_rod:anim 
дівчина                  noun:f:v_naz:anim 
ж	                     conj:coord 
ж	                     part 
жалітися	             verb:rev:inf:imperf 
живу	                 adj:f:v_zna:compb 
з	                     prep:rv_rod:rv_zna:rv_oru 
за	                     prep:rv_rod:rv_zna:rv_oru 
забезпечили	             verb:past:p:perf 
забрати                  verb:inf:perf 
завищені	             adjp:pasv:past:p:v_zna 
загалом	                 adv
задоволені               adj:p:v_naz:compb:&adjp:pasv:past
зайве	                 adj:n:v_zna 
зайти	                 verb:inf:perf 
зайшли	                 verb:past:p:perf 
заклад	                 noun:m:v_naz(mis) 
заклад	                 noun:m:v_zna 
закладами	             noun:p:v_oru 
закладах	             noun:p:v_mis 
закладу	                 noun:m:v_dav 
закладу 	             noun:m:v_rod 
закладі	                 noun:m:v_mis 
закладів	             noun:p:v_rod
закручена	             adjp:pasv:past:f:v_naz 
закуски	                 noun:p:v_naz 
залишили	             verb:past:p:perf 
замовили	             verb:past:p:perf 
замовлення	             noun:n:v_zna
запеченої	             adjp:pasv:past:f:v_rod 
запитала	             verb:past:f:perf 
запропонувала	         verb:past:f:perf 
заробити	             verb:inf:perf 
зберіганням	             noun:n:v_oru 
зв'язок	                 noun:m:v_naz 
зверніть	             verb:impr:p:2:perf 
звички	                 noun:f:v_rod
звідси 	                 adv:&pron:dem
згоди	                 noun:f:v_rod 
злапали	                 verb:past:p:perf 
знаю	                 verb:pres:s:1:imperf 
знаєте	                 verb:pres:p:2:imperf
знову	                 adv 
зовнішній	             adj:m:v_zna 
зрадити	                 verb:inf:perf 
зробили	                 verb:past:p:perf 
зручні	                 adj:p:v_naz:compb 
зіпсутий	             adjp:pasv:past:m:v_zna
зіпсуті	                 adjp:pasv:past:p:v_zna 
й	                     conj:coord
його	                 adj:m:nv:&pron:pos
кажуть	                 verb:pres:p:3:imperf 
карткою	                 noun:f:v_oru
картопельку              noun:f:v_zna
картопля                 noun:f:v_naz 
картоплі	             noun:f:v_rod 
каси	                 noun:p:v_naz 
касі	                 noun:f:v_mis
кафе-бістро	             noun:n:v_mis:nv:nv 
кафешки	                 noun:f:v_rod:slang 
клієнта	                 noun:m:v_rod:anim 
клієнтів	             noun:p:v_rod:anim 
ковбаска	             noun:f:v_naz 
кожного	                 adj:m:v_rod:&pron:def  
кожної	                 adj:f:v_rod:&pron:def 
коли	                 adv:&pron:int:rel
компот	                 noun:m:v_naz 
кому	                 noun:f:v_zna 
котлети	                 noun:p:v_naz  
котрий	                 adj:m:v_zna:&pron:int 
кудись	                 adv:&pron:ind 
купа	                 noun:f:v_naz 
купила	                 verb:past:f:perf 
купити	                 verb:inf:perf 
кухні	                 noun:f:v_dav 
кількістю	             noun:f:v_oru 
лате	                 noun:m:v_zna:nv:np 
лиш	                     part 
лишалося	             verb:rev:past:n:imperf 
ложка	                 noun:f:v_naz 
людей	                 noun:p:v_zna:anim 
люди	                 noun:p:v_naz:anim 
людина	                 noun:f:v_naz:anim
людини	                 noun:f:v_rod:anim 
людину	                 noun:f:v_zna:anim
м'яса	                 noun:n:v_rod
мабуть	                 insert 
мав	                     verb:past:m:imperf 
майже	                 adv  
майонез 	             noun:m:v_zna 
максимум	             adv
максимум                 noun:m:v_zna  
мала	                 adj:f:v_naz:compb
маленький                adj:m:v_zna 
мало	                 adv:compb
малу	                 adj:f:v_zna:compb 
мамою	                 noun:f:v_oru:anim 
манери	                 noun:p:v_zna 
маю	                     verb:pres:s:1:imperf 
мене	                 pron:pers:s:1:v_rod:anim 
менеджера	             noun:m:v_rod:anim 
менші	                 adj:p:v_zna:compr 
мені	                 pron:pers:s:1:v_dav:anim
мережі	                 noun:f:v_rod                                            
ми	                     pron:pers:p:1:v_naz:anim 
минулому	             adjp:actv:past:m:v_mis 
млинці	                 noun:p:v_naz 
може	                 verb:unknown 
можете	                 verb:unknown 
можна	                 predic 
можу	                 verb:unknown 
можуть 	                 verb:unknown 
моє	                     adj:n:v_zna:&pron:pos 
моєї	                 adj:f:v_rod:&pron:pos
мої	                     adj:p:v_naz:&pron:pos 
між	                     prep:rv_rod:rv_zna:rv_oru
мій	                     adj:m:v_zna:&pron:pos 
мінімум	                 noun:m:v_zna
місяць	                 noun:m:v_zna 
на	                     part 
на	                     prep:rv_zna:rv_mis
набагато	             adv 
навіть	                 part 
надто	                 adv 
називають                verb:pres:p:3:imperf 
накинула	             verb:past:f:perf 
накладала	             verb:past:f:imperf 
налили	                 verb:past:p:perf 
налити	                 verb:inf:perf 
наллє	                 verb:futr:s:3:perf
нам	                     pron:pers:p:1:v_dav:anim 
напої	                 verb:impr:s:2:perf 
наприклад	             insert 
нас	                     pron:pers:p:1:v_mis:anim 
нахабно	                 adv:compb 
нахабство	             noun:n:v_naz 
наш	                     adj:m:v_zna:&pron:pos 
нашій	                 adj:f:v_mis:&pron:pos 
не	                     part 
недавно	                 adv 
неймовірно	             adv:compb 
нема	                 predic 
немає	                 predic 
неможна	                 adj:f:v_naz:rare
необачності	             noun:f:v_dav
необережність	         noun:f:v_zna 
несвіжий	             adj:m:v_zna 
несмачної	             adj:f:v_rod
них	                     pron:pers:p:3:v_mis:anim 
нормальне	             adj:n:v_naz 
нормального	             adj:m:v_rod 
нормальні	             adj:p:v_zna 
ні	                     part 
ніж	                     conj:subord 
ніжці	                 noun:f:v_mis 
ніколи	                 adv:&pron:neg 
нікому	                 pron:neg:v_dav:anim 
ніч	                     noun:f:v_zna 
нічого	                 adv 
ніяк	                 predic 
о	                     prep:rv_zna:rv_mis 
обманула	             verb:past:f:perf
обмані	                 noun:m:v_mis
обслуговувала	         verb:past:f:imperf 
обслуговування	         noun:n:v_naz
обслуговування	         noun:n:v_zna 
обслуговують	         verb:pres:p:3:imperf 
обслуговує	             verb:pres:s:3:imperf 
обслужити	             verb:inf:perf 
обурення	             noun:n:v_naz
обурило                  verb:past:n:perf 
обід	                 noun:m:v_zna
обідній	                 adj:m:v_zna 
один	                 numr:m:v_naz 
одна	                 numr:f:v_naz 
одне	                 numr:n:v_zna 
одному	                 numr:m:v_mis 
одну	                 numr:f:v_zna 
особливо                 adv 
останній	             adj:m:v_zna  
офіціантки	             noun:p:v_naz:anim 
очевидно	             insert 
перебування	             noun:n:v_rod
передумала	             verb:past:f:perf
пережили	             verb:past:p:perf
перепитують	             verb:pres:p:3:imperf 
перепросила	             verb:past:f:perf
персонал	             noun:m:v_naz
персоналу	             noun:m:v_rod
перший	                 adj:m:v_zna 
першої	                 adj:f:v_rod 
перші	                 adj:p:v_naz 
перші	                 adj:p:v_zna 
печінковий	             adj:m:v_zna 
пива	                 noun:n:v_rod 
пиво	                 noun:n:v_zna 
пильнувати	             verb:inf:imperf 
по	                     prep:rv_mis:rv_zna 
по-людськи	             adv
побачила	             verb:past:f:perf 
поведінку	             noun:f:v_zna 
повернув	             verb:past:m:perf 
повернути	             verb:inf:perf 
повеселило               verb:past:n:perf 
повними	                 adj:p:v_oru:compb 
повну	                 adj:f:v_zna:compb 
поводься	             verb:rev:impr:s:2:imperf 
повірте	                 verb:impr:p:2:perf  
поганий	                 adj:m:v_naz:compb
погано	                 adv:compb 
погодилась	             verb:rev:past:f:perf 
погодитися	             verb:rev:inf:perf 
подальше	             adj:n:v_naz 
подивитеся	             verb:rev:futr:p:2:perf 
подобались	             verb:rev:past:p:imperf 
поки	                 adv:&pron:int:rel
поки	                 adv:&pron:int:rel
помістилося	             verb:rev:past:n:perf
помітили	             verb:past:p:perf 
понюхала	             verb:past:f:perf 
пообідати	             verb:inf:perf 
попросила	             verb:past:f:perf  
порцію	                 noun:f:v_zna 
порції	                 noun:p:v_naz 
порції	                 noun:p:v_zna 
порівнювати	             verb:inf:imperf 
порівнянні	             adj:p:v_naz(mis)
порівняти	             verb:inf:perf 
посуди	                 verb:impr:s:2:perf
посудини	             noun:f:v_rod 
почав	                 verb:past:m:perf 
почервоніла	             adjp:actv:past:f:v_naz
пошкодували	             verb:past:p:perf
працюю	                 verb:pres:s:1:imperf  
представникі             noun:p:v_rod:anim 
при	                     prep:rv_mis 
прибиральників	         noun:p:v_rod:anim 
приблизно	             adv:compb 
привітний	             adj:m:v_zna:compb 
привітні	             adj:p:v_naz:compb 
приготуйтесь	         verb:rev:impr:p:2:perf 
придбайте	             verb:impr:p:2:perf 
прийдемо	             verb:futr:p:1:perf 
пристойна	             adj:f:v_naz 
приємно	                 adv:compb 
приїжджала	             verb:past:f:imperf 
про	                     prep:rv_zna  
проблеми	             noun:f:v_rod 
продавщицю	             noun:f:v_zna:bad:anim 
продавщиця	             noun:f:v_naz:bad:anim 
продукт	                 noun:m:v_naz
продуктів	             noun:p:v_rod
продукції	             noun:f:v_rod 
пройти	                 verb:inf:perf 
проковтнете	             verb:futr:p:2:perf  
пролежала	             verb:past:f:perf 
пролізти	             verb:inf:perf 
пропонувати	             verb:inf:imperf 
просити	                 verb:inf:imperf 
проспекті	             noun:m:v_mis 
просто	                 adv:compb 
протирати	             verb:inf:imperf 
прохання	             noun:n:v_rod 
прочекали	             verb:past:p:perf 
пузатої	                 adj:f:v_rod 
під	                     prep:rv_zna:rv_oru 
підносами	             noun:p:v_oru 
підносі	                 noun:m:v_mis 
пізніше	                 adj:n:v_zna:compr
пік	                     noun:m:v_zna 
після	                 adv 
раз	                     conj:subord 
разу	                 noun:m:v_rod 
рекомендувати	         verb:inf:imperf
ресторані	             noun:m:v_mis 
риби	                 noun:f:v_rod:anim 
роби	                 verb:impr:s:2:imperf
роблять	                 verb:pres:p:3:imperf 
робітниками	             noun:p:v_oru:anim 
робітників	             noun:p:v_rod:anim
роздачі	                 noun:f:v_mis
розливати	             verb:inf:imperf 
розлити	                 verb:inf:perf 
розмов	                 noun:p:v_rod 
розміру  	             noun:m:v_rod 
розрахуватися	         verb:rev:inf:perf 
розрахунок	             noun:m:v_zna 
розрізана	             adjp:pasv:past:f:v_naz 
роки	                 noun:p:v_zna 
ручкою	                 noun:f:v_oru 
рідко	                 adv:compb 
рідні	                 adj:p:v_naz:compb 
салати	                 noun:p:v_zna
сама	                 adj:f:v_naz:&pron:def 
самому	                 adj:m:v_dav:&pron:def
самі	                 adj:p:v_naz:&pron:def 
свіжий	                 adj:m:v_zna:compb 
свіжі	                 adj:p:v_naz:compb 
свій	                 adj:m:v_naz:&pron:pos
серпні	                 noun:m:v_mis
сином	                 noun:m:v_oru:anim 
сиром	                 noun:m:v_oru 
скажімо	                 insert
сказала 	             verb:past:f:perf 
скандалити	             verb:inf:imperf  
скарг	                 noun:p:v_rod 
склянки	                 noun:f:v_rod  
склянку	                 noun:f:v_zna 
скільки	                 numr:p:v_naz:&pron:ind 
смак	                 noun:m:v_zna 
смачні	                 adj:p:v_naz:compb 
смерділа	             verb:past:f:imperf 
сметану	                 noun:f:v_zna 
снують	                 verb:pres:p:3:imperf 
собі	                 pron:refl:n:v_dav
соки	                 noun:p:v_zna 
спорожнілої	             adjp:actv:past:f:v_rod 
спробувати	             verb:inf:perf 
спробуєте	             verb:futr:p:2:perf 
співробітників	         noun:p:v_rod:anim 
стало	                 adv 
старих	                 adj:p:v_mis:compb 
створюються	             verb:rev:pres:p:3:imperf 
столик	                 noun:m:v_zna 
столиками	             noun:p:v_oru 
столики	                 noun:p:v_naz 
столиків	             noun:p:v_rod 
стосовно	             adv 
стосується	             verb:rev:pres:s:3:imperf 
страв	                 noun:p:v_rod 
страви	                 noun:p:v_zna 
стрільців	             noun:p:v_rod:anim 
субота	                 noun:f:v_naz 
сьогоднішній	         adj:m:v_zna 
сягнуло	                 verb:past:n:perf 
січня	                 noun:m:v_rod
та	                     conj:coord
та	                     conj:coorderf 
та	                     part 
так	                     adv:&pron:dem
така	                 adj:f:v_naz:&pron:def 
також	                 adv
такої	                 adj:f:v_rod:&pron:def 
таку	                 adj:f:v_zna:&pron:def 
там	                     adv:&pron:dem
тарілки	                 noun:f:v_rod
твоєму	                 adj:m:v_dav:&pron:pos
те	                     adj:n:v_zna:&pron:dem 
тебе	                 pron:pers:s:2:v_rod:anim
тепленьке-свіженьке      adj:n:v_naz 
термінали	             noun:p:v_naz
тих	                     adj:p:v_rod:&pron:dem
то	                     conj:subord  
того	                 adj:m:v_rod:&pron:dem 
тому	                 adv 
тому	                 conj:subord 
тонші	                 adj:p:v_zna:compr 
торт	                 noun:m:v_zna 
торта	                 noun:m:v_rod
точно	                 adv 
травні	                 adj:p:v_zna(mis)
траплялися	             verb:rev:past:p:imperf 
треба	                 predic 
третина	                 noun:f:v_naz 
три	                     numr:p:v_zna 
ту	                     adj:f:v_zna:&pron:dem 
туди	                 adv:&pron:dem 
тут	                     adv:&pron:dem 
тікати	                 verb:inf:imperf 
тільки	                 adv  
тільки	                 part 
у                        prep:rv_zna:rv_mis:rv_rod:v-u 
увагу	                 noun:f:v_zna
увагу	                 noun:f:v_zna
усюди	                 adv:gen:v-u:&pron 
фаст-фудом               noun:m:v_oru
франківську	             adj:f:v_zna 
харчування	             noun:n:v_rod 
харчуюся	             verb:rev:pres:s:1:imperf 
хати	                 noun:f:v_rod 
хаті	                 noun:f:v_mis 
хвилин	                 noun:p:v_rod 
ходив	                 verb:past:m:imperf 
холодильнику	         noun:m:v_dav  
хот-доги	             noun:p:v_zna 
хотіла	                 verb:unknown 
хотілося	             verb:unknown 
хочете	                 verb:unknown 
хіба	                 conj:subord  
це	                     adj:n:v_zna:&pron:dem 
це	                     adj:n:v_zna:&pron:dem(part)
цей	                     adj:m:v_zna:&pron:dem 
центрі	                 noun:m:v_mis 
цибулею	                 noun:f:v_oru
цибулю	                 noun:f:v_zna  
цього	                 adj:m:v_rod:&pron:dem
цілий	                 adj:m:v_zna
цін	                     noun:p:v_rod 
ціна	                 noun:f:v_naz 
ціни	                 verb:impr:s:2:imperf 
цієї	                 adj:f:v_rod:&pron:dem 
чайових	                 noun:p:v_mis
час	                     noun:m:v_zna 
часто	                 adv:compb 
чемність	             noun:f:v_zna
черги	                 noun:p:v_naz 
чи	                     conj:coord:subord
читати	                 verb:inf:imperf 
чоловіком	             noun:m:v_oru:anim 
чула	                 adj:f:v_naz 
чітко	                 adv:compb 
шанувати	             verb:inf:imperf 
швидке	                 adj:n:v_zna:compb 
швидкого	             adj:m:v_rod:compb 
шинкою	                 noun:f:v_oru
шкода	                 noun:f:v_naz 
шматок	                 noun:m:v_zna 
шматочок	             noun:m:v_zna 
шокувати	             verb:inf:perf 
ще	                     adv 
ще	                     part  
що	                     conj:subord  
що	                     pron:int:rel:n:v_zna
щоб	                     conj:subord 
щось	                 pron:ind:n:v_zna 
я	                     pron:pers:s:1:v_naz:anim 
яблуками	             noun:p:v_oru 
як	                     adv:&pron:int:rel
як	                     conj:subord
як	                     part 
яка	                     noun:m:v_rod:anim(conj:subord)
який	                 adj:m:v_naz:&pron:int:rel:def
яких	                 adj:p:v_rod:&pron:int:rel:def
якщо	                 conj:subord  
які	                     adj:p:v_naz:&pron:int:rel:def
якісне	                 adj:n:v_zna:compb 
якість	                 noun:f:v_naz 
якістю	                 noun:f:v_oru 
є	                     verb:pres:s:2:imperf
єдине	                 adj:n:v_zna 
і	                     conj:coord                                    
іншим	                 adj:m:v_oru:&pron:def
іншими	                 adj:p:v_oru:&pron:def 
інших	                 adj:p:v_mis:&pron:def                                   
іншого	                 adj:n:v_rod:&pron:def 
іти	                     verb:inf:imperf 
їжа	                     noun:f:v_naz 
їжі	                     noun:f:v_rod 
їй	                     pron:pers:f:3:v_dav:anim
їх	                     pron:pers:p:3:v_zna:anim
її	                     adj:f:nv:&pron:pos